Orthography	Segments
A B A C K	ʌ b æ k
A B B R E V I A T I O N	ʌ b ɹ i v i eɪ ʃ ʌ n
A B R U Z Z O	ɑ b ɹ u z oʊ
A C C E S S I N G	æ k s ɛ s ɪ ŋ
A C E R B I C	ʌ s ɛ ɹ b ɪ k
A C K E R M A N N	æ k ɝ m ʌ n
A D A P T A B I L I T Y	ʌ d æ p t ʌ b ɪ l ʌ t i
A D J O I N I N G	ʌ dʒ ɔɪ n ɪ ŋ
A D M I N I S T E R E D	ʌ d m ɪ n ɪ s t ɝ d
A D O L E S C E N C E	æ d ʌ l ɛ s ʌ n s
A D V E N T U R E R S	ʌ d v ɛ n tʃ ɝ ɝ z
A D V E R S E	æ d v ɝ s
A F F I X	æ f ɪ k s
A G A C H E S	æ ɡ æ tʃ ʌ z
A G E N C Y S	eɪ dʒ ʌ n s i z
A I S L E S	aɪ ʌ l z
A L B A N Y S	ɔ l b ʌ n i z
A L B E R T S	æ l b ɝ t s
A L C O	æ l k oʊ
A L D E N	ɑ l d ʌ n
A L E J A N D R E	ɑ l eɪ j ɑ n d ɹ eɪ
A L I Q U I P P A	æ l ʌ k w ɪ p ʌ
A L L A Y I N G	ʌ l eɪ ɪ ŋ
A L M I G H T Y	ɔ l m aɪ t i
A L R E A D Y	ɔ l ɹ ɛ d i
A L T E R N A T I V E L Y	ɔ l t ɝ n ʌ t ɪ v l i
A M E L I T A	ɑ m ɛ l i t ʌ
A M O S	eɪ m ʌ s
A N A C O R T E S	æ n ʌ k ɔ ɹ t ʌ s
A N A S T O S	æ n ʌ s t oʊ z
A N D E L	æ n d ʌ l
A N G E R	æ ŋ ɡ ɝ
A N G O L A S	æ ŋ ɡ oʊ l ʌ z
A N N I S S A	æ n i s ʌ
A P P R O V I N G	ʌ p ɹ u v ɪ ŋ
A Q U I L A	æ k w ʌ l ʌ
A R B A T	ɑ ɹ b æ t
A R C H B I S H O P	ɑ ɹ tʃ b ɪ ʃ ʌ p
A R C H I M E D E S	ɑ ɹ k ʌ m i d i z
A R G O N N E	ɑ ɹ ɡ oʊ n
A R M A M E N T S	ɑ ɹ m ʌ m ʌ n t s
A R S E N I O	ɑ ɹ s i n i oʊ
A R T I C L E	ɑ ɹ t ɪ k ʌ l
A R T I C U L A T E D	ɑ ɹ t ɪ k j ʌ l eɪ t ɪ d
A R T Y S	ɑ ɹ t i z
A S S A I L	ʌ s eɪ l
A S S E S S O R	ʌ s ɛ s ɝ
A S T R O P H Y S I C S	æ s t ɹ oʊ f ɪ z ɪ k s
A U D I T O R I U M S	ɔ d ɪ t ɔ ɹ i ʌ m z
A U T O B I O G R A P H I C A L	ɔ t ʌ b aɪ ʌ ɡ ɹ æ f ɪ k ʌ l
A V A L O S	ɑ v ɑ l oʊ z
A V E R I L	eɪ v ɝ ɪ l
A V N E T	æ v n ɛ t
A W F U L L Y	ɔ f ʌ l i
A Z I Z	ʌ z i z
A Z P U R U A	æ z p j ʊ ɹ u ʌ
B A C K E R	b æ k ɝ
B A D A L A M E N T I	b ɑ d ɑ l ɑ m ɛ n t i
B A G U E T T E	b æ ɡ ɛ t
B A K O S	b ɑ k oʊ z
B A L S I G E R	b æ l s ɪ ɡ ɝ
B A N D O L I E R S	b æ n d ʌ l ɪ ɹ z
B A N J A	b ɑ n j ʌ
B A N K N O T E S	b æ ŋ k n oʊ t s
B A N K R U P T E D	b æ ŋ k ɹ ʌ p t ɪ d
B A R B E	b ɑ ɹ b
B A R C L A Y S	b ɑ ɹ k l i z
B A R G A I N S	b ɑ ɹ ɡ ʌ n z
B A R G E R O N	b ɑ ɹ ɡ ɝ ʌ n
B A R T	b ɑ ɹ t
B A S I N G	b eɪ s ɪ ŋ
B A S T A R A C H E	b ɑ s t ɑ ɹ eɪ k
B A U G H N	b ɔ n
B A Y B A N K S	b eɪ b æ ŋ k s
B A Z O O K A S	b ʌ z u k ʌ z
B E A L S	b i l z
B E A M O N	b i m ʌ n
B E A R Y	b ɪ ɹ i
B E D O Y A	b eɪ d ɔɪ ʌ
B E D R O O M S	b ɛ d ɹ u m z
B E D S I D E	b ɛ d s aɪ d
B E H R E N D S	b ɛ ɹ ɛ n d z
B E I E R L E	b aɪ ɝ ʌ l
B E I L	b i l
B E L E F I V I L L E	b ʌ l ɛ f ʌ v ɪ l
B E L S E R	b ɛ l s ɝ
B E N F E R	b ɛ n f ɝ
B E N I G H T S	b i n aɪ t s
B E R W A N G E R	b ɝ w ɔ ŋ ɝ
B E T T E R M E N T	b ɛ t ɝ m ʌ n t
B I C K L E R	b ɪ k l ɝ
B I L I N G U A L I S M	b aɪ l ɪ ŋ ɡ w ʌ l ɪ z ʌ m
B I R D Y	b ɝ d i
B L A S C H K E	b l æ ʃ k
B L E A	b l i
B L O C K I N G	b l ɑ k ɪ ŋ
B L U F F S	b l ʌ f s
B O B E K	b oʊ b ɪ k
B O D Y S	b ɑ d i z
B O E S E L	b oʊ s ʌ l
B O G D A N O W I C Z	b ʌ ɡ d æ n ʌ w ɪ tʃ
B O N A D I O	b oʊ n ɑ d i oʊ
B O S E M A N	b oʊ s m ʌ n
B O T T L E R S	b ɑ t l ɝ z
B O U C H E R	b aʊ tʃ ɝ
B R A N D E	b ɹ æ n d
B R A N S T A D	b ɹ æ n s t æ d
B R E A U	b ɹ oʊ
B R E I T E N B A C H	b ɹ aɪ t ɪ n b ɑ k
B R E N D A	b ɹ ɛ n d ʌ
B R I C K E Y	b ɹ ɪ k i
B R I G H A M S	b ɹ ɪ ɡ ʌ m z
B R I N L E Y	b ɹ ɪ n l i
B R O O K S S	b ɹ ʊ k s
B R O W E R	b ɹ aʊ ɝ
B U C H I S	b ʌ tʃ i z
B U L L H O R N S	b ʊ l h ɔ ɹ n z
B U L L O C K	b ʊ l ʌ k
B U M P S	b ʌ m p s
B U R S T S	b ɝ s t s
B U T R O S	b u t ɹ ʌ s
B Y Z A N T I N E	b ɪ z ʌ n t i n
C A B A R E T	k æ b ɝ eɪ
C A B L E V I S I O N S	k eɪ b ʌ l v ɪ ʒ ʌ n z
C A E S A R S	s i z ɝ z
C A L T A G I R O N E	k ɑ l t ɑ dʒ ɪ ɹ oʊ n i
C A L V E R A S	k æ l v ɛ ɹ ʌ s
C A M B E X	k æ m b ʌ k s
C A N T O N E	k ɑ n t oʊ n i
C A N T O R E	k æ n t ɔ ɹ
C A P A C I T Y	k ʌ p æ s ʌ t i
C A R D O O N	k ɑ ɹ d u n
C A R D S	k ɑ ɹ d z
C A R I N G	k ɛ ɹ ɪ ŋ
C A R N	k ɑ ɹ n
C A R N I N E	k ɑ ɹ n i n i
C A S H I E R S	k æ ʃ ɪ ɹ z
C A T A I N	k æ t ɛ n
C A V E Y	k eɪ v i
C E A S E D	s i s t
C E L L A	s ɛ l ʌ
C E N S O R S H I P	s ɛ n s ɝ ʃ ɪ p
C E N T E N O	tʃ ɛ n t ɛ n oʊ
C E R T A I N T Y	s ɝ t ʌ n t i
C E R V E R A	tʃ ɝ v ɛ ɹ ʌ
C H A I K E N	tʃ eɪ k ʌ n
C H A I N I N G	tʃ eɪ n ɪ ŋ
C H A P M A N	tʃ æ p m ʌ n
C H A R A C T E R I S T I C A L L Y	k ɛ ɹ ɪ k t ɝ ɪ s t ɪ k l i
C H A U F F E U R S	ʃ oʊ f ɝ z
C H E R R Y S	tʃ ɛ ɹ i z
C H E R U B S	tʃ ɛ ɹ ʌ b z
C H E S H I R E	tʃ ɛ ʃ ɝ
C H E S S B O A R D S	tʃ ɛ s b ɔ ɹ d z
C H I A P P E T T A	k i ɑ p ɛ t ʌ
C H I F F R E	ʃ i f ɹ ʌ
C H I L D L I K E	tʃ aɪ l d l aɪ k
C H I S A M	tʃ ɪ s ʌ m
C H I S E L E D	tʃ ɪ z ʌ l d
C H I T W O O D	tʃ ɪ t w ʊ d
C H O K E	tʃ oʊ k
C H U R C H M A N	tʃ ɝ tʃ m ʌ n
C H U R C H W E L L	tʃ ɝ tʃ w ɛ l
C L A S H I N G	k l æ ʃ ɪ ŋ
C L A S S M A N	k l æ s m ʌ n
C L A Y B O R N E	k l eɪ b ɝ n
C L E R K S	k l ɝ k s
C L O S E U P	k l oʊ s ʌ p
C O C C O	k oʊ k oʊ
C O G E N E R A T O R	k oʊ dʒ ɛ n ɝ eɪ t ɝ
C O K L E Y	k ɑ k l i
C O L L A R B O N E	k ɑ l ɝ b oʊ n
C O L L E V I L L E	k oʊ l v ɪ l
C O L L I D E	k ʌ l aɪ d
C O L L I N S O N	k ɑ l ɪ n s ʌ n
C O M F O R T E R S	k ʌ m f ɝ t ɝ z
C O M M O N L Y	k ɑ m ʌ n l i
C O M O	k oʊ m oʊ
C O N C E N T R A T E S	k ɑ n s ʌ n t ɹ eɪ t s
C O N C E P C I O N	k ʌ n s ɛ p s i oʊ n
C O N D E N S E D	k ʌ n d ɛ n s t
C O N Q U E R	k ɑ ŋ k ɝ
C O N S E C R A T E	k ɑ n s ʌ k ɹ eɪ t
C O N T I N E N T A L L Y	k ɑ n t ʌ n ɛ n t ʌ l i
C O R T E S	k ɔ ɹ t ɛ z
C O S P E R	k ɑ s p ɝ
C O S T E D	k ɑ s t ɪ d
C O U C H E D	k aʊ tʃ t
C O U N T E R T R A D E	k aʊ n t ɝ t ɹ eɪ d
C O U N T E S S	k aʊ n t ʌ s
C R A B B	k ɹ æ b
C R O S T O N	k ɹ ɑ s t ʌ n
C R U I S I N G	k ɹ u z ɪ ŋ
C R U M B Y	k ɹ ʌ m b i
C R U T H I R D S	k ɹ ʌ θ ɝ d z
C S P I	s i ɛ s p i aɪ
C U L B E R T	k ʌ l b ɝ t
C U P I D I T Y	k j u p ɪ d ɪ t i
C U R R E N C I E S	k ɝ ɛ n s i z
C Y P R I S	s aɪ p ɹ ɪ s
D A M B A C H E R	d æ m b ɑ k ɝ
D A N U B E	d æ n j u b
D A R R E L L	d ɛ ɹ ʌ l
D A U M	d ɔ m
D A W N S	d ɔ n z
D A Y T O N A	d eɪ t oʊ n ʌ
D E A R I N G	d ɪ ɹ ɪ ŋ
D E C O O K	d ɛ k ʊ k
D E D E C K E R	d ɛ d ɪ k ɝ
D E H L E R	d ɛ l ɝ
D E I O N	d i ɑ n
D E J O N G H	d ʌ dʒ ɔ ŋ
D E K A Y	d ʌ k eɪ
D E L I B E R A T E L Y	d ɪ l ɪ b ɹ ʌ t l i
D E L I S T	d i l ɪ s t
D E L O R I A	d ɛ l ɔ ɹ i ʌ
D E M A R I O	d ɪ m ɑ ɹ i oʊ
D E M B O W S K I	d ɪ m b ɔ f s k i
D E M O G R A P H E R S	d ɪ m ɑ ɡ ɹ ʌ f ɝ z
D E M O R A L I Z E	d ɪ m ɔ ɹ ʌ l aɪ z
D E M Y S T I F Y	d i m ɪ s t ʌ f aɪ
D E N M O N	d ɛ n m ʌ n
D E N S M O R E	d i n s m ɔ ɹ
D E R	d ɝ
D E R E N	d ɪ ɹ ʌ n
D E T E C T I N G	d ɪ t ɛ k t ɪ ŋ
D E T E R M I N E D L Y	d ʌ t ɝ m ʌ n d l i
D E U T S C H E	d ɔɪ tʃ
D I E T I T I A N S	d aɪ ʌ t ɪ ʃ ʌ n z
D I F F E R E N T I A T E D	d ɪ f ɝ ɛ n tʃ i eɪ t ʌ d
D I G I T I Z E	d ɪ dʒ ʌ t aɪ z
D I N G L E	d ɪ ŋ ɡ ʌ l
D I O X I D E S	d aɪ ɑ k s aɪ d z
D I R E C T O R I E S	d i ɹ ɛ k t ɝ i z
D I S A V O W	d ɪ s ʌ v aʊ
D I S C O V E R Y	d ɪ s k ʌ v ɹ i
D I S H M A N	d ɪ ʃ m ʌ n
D I S S E C T I O N S	d aɪ s ɛ k ʃ ʌ n z
D I S T R I B U T E S	d ɪ s t ɹ ɪ b j u t s
D I T T O	d ɪ t oʊ
D I V I N G	d aɪ v ɪ ŋ
D O C U M E N T E D	d ɑ k j u m ɛ n t ʌ d
D O R A L I N	d ɔ ɹ ɑ l i n
D O R E	d ɔ ɹ
D O S S E Y	d ɑ s i
D O U B T	d aʊ t
D O V E R	d oʊ v ɝ
D R E I B E L B I S	d ɹ aɪ b ɪ l b ɪ s
D R E S N E R	d ɹ ɛ z n ɝ
D R O P O F F	d ɹ ɑ p ɔ f
D R U M M I N G	d ɹ ʌ m ɪ ŋ
D U F F I N	d ʌ f ɪ n
D U N G E O N	d ʌ n dʒ ʌ n
D U P L I C A T I V E	d u p l ɪ k ʌ t ɪ v
E C C E N T R I C S	ɛ k s ɛ n t ɹ ɪ k s
E C K E R	ɛ k ɝ
E C O N O M I C	ɛ k ʌ n ɑ m ɪ k
E C R U	ɛ k ɹ u
E D I T O R S H I P	ɛ d ʌ t ɝ ʃ ɪ p
E G G E R S	ɛ ɡ ɝ z
E H M A N N	ɛ m ʌ n
E I C H H O R N	aɪ k h ɝ n
E I N S P A H R	aɪ n s p ɑ ɹ
E I S E N H O U R	aɪ z ʌ n aʊ ɹ
E L E K T R I S K	ɪ l ɛ k t ɹ ɪ s k
E L Z A	ɛ l z ʌ
E M E R S O N	ɛ m ɝ s ʌ n
E M I N E N T L Y	ɛ m ʌ n ʌ n t l i
E M P E R O R S	ɛ m p ɝ ɝ z
E N A M O R I N G	ɛ n æ m ɝ ɪ ŋ
E N C A S E D	ɛ n k eɪ s t
E N C O M P A S S	ɛ n k ʌ m p ʌ s
E N C Y C L O P A E D I A	ɪ n s aɪ k l oʊ p i d i ʌ
E N D P O I N T	ɛ n d p ɔɪ n t
E N G E R T	ɛ ŋ ɡ ɝ t
E N G L E W O O D	ɛ ŋ ɡ ʌ l w ʊ d
E N G L U N D	ɪ ŋ l ʌ n d
E N O R M O U S L Y	i n ɔ ɹ m ʌ s l i
E N S H R I N E	ɛ n ʃ ɹ aɪ n
E N T R A P	ɪ n t ɹ æ p
E P I S T O L A R Y	ɪ p ɪ s t ʌ l ɛ ɹ i
E P P L E Y	ɛ p l i
E Q U I P M E N T S	ɪ k w ɪ p m ʌ n t s
E Q U I T Y S	ɛ k w ʌ t i z
E Q U I V A L E N T	ɪ k w ɪ v ʌ l ʌ n t
E R I S A	ɛ ɹ i s ʌ
E R L E R	ɝ l ɝ
E R M A	ɝ m ʌ
E S C A L A T E D	ɛ s k ʌ l eɪ t ɪ d
E S C O R T I N G	ɛ s k ɔ ɹ t ɪ ŋ
E S C O R T S	ɛ s k ɔ ɹ t s
E V A N O V	ɛ v ʌ n ɔ v
E V I C T I N G	ɪ v ɪ k t ɪ ŋ
E W T O N	j u t ʌ n
E X H A U S T I V E	ɪ ɡ z ɔ s t ɪ v
E X P E N D I T U R E S	ɪ k s p ɛ n d ʌ tʃ ɝ z
F A B R I C A T E D	f æ b ɹ ɪ k eɪ t ʌ d
F A I R A L L	f ɛ ɹ ɔ l
F A I R G R O U N D	f ɛ ɹ ɡ ɹ aʊ n d
F A I R Y L A N D	f ɛ ɹ i l æ n d
F A M I N E S	f æ m ʌ n z
F A N E	f eɪ n
F A R L E Y	f ɑ ɹ l i
F A U S	f ɔ z
F A U S T I N E	f aʊ s t i n
F E D E R A L I S M	f ɛ d ɹ ʌ l ɪ z ʌ m
F E D E R A L I Z E D	f ɛ d ɝ ʌ l aɪ z d
F E D E R A L I Z I N G	f ɛ d ɹ ʌ l aɪ z ɪ ŋ
F E E D L O T S	f i d l ɑ t s
F E I N B E R G	f aɪ n b ɝ ɡ
F E R D	f ɝ d
F E R V E N T L Y	f ɝ v ʌ n t l i
F E S T I V A L	f ɛ s t ɪ v ʌ l
F E T T I G	f ɛ t ɪ ɡ
F I N I G A N	f ɪ n ɪ ɡ ʌ n
F I R E F I G H T E R	f aɪ ɹ f aɪ t ɝ
F I S C H	f ɪ ʃ
F L A U N T	f l ɔ n t
F L I R T	f l ɝ t
F L I R T I N G	f l ɝ t ɪ ŋ
F L O A T E R	f l oʊ t ɝ
F O C A C C I A	f oʊ k ɑ tʃ i ʌ
F O G E L S O N	f oʊ ɡ ʌ l s ʌ n
F O I S T E R	f ɔɪ s t ɝ
F O R M A L D E H Y D E	f ɔ ɹ m æ l d ʌ h aɪ d
F R A N K I E	f ɹ æ ŋ k i
F R E D E R I C K S	f ɹ ɛ d ɝ ɪ k s
F R E D R I C H	f ɹ ɛ d ɹ ɪ k
F R I E S E N	f ɹ i s ʌ n
F U J I K A W A	f u dʒ i k ɑ w ʌ
F U J I T S U S	f u dʒ ɪ t s u z
F U K L A H S	f u k l ʌ z
F U L F I L L I N G	f ʊ l f ɪ l ɪ ŋ
F U N D A M E N T A L I S T S	f ʌ n d ʌ m ɛ n ʌ l ɪ s
F U N N E L I N G	f ʌ n ʌ l ɪ ŋ
F U R R	f ɝ
F U R R I E R	f ɝ i ɝ
G A B A Y	ɡ æ b eɪ
G A I N O R	ɡ eɪ n ɝ
G A L	ɡ æ l
G A L L E R	ɡ ɔ l ɝ
G A M I N G S	ɡ eɪ m ɪ ŋ z
G A R A R D	ɡ ɝ ɑ ɹ d
G A R B L E D	ɡ ɑ ɹ b ʌ l d
G A R I B A L D I	ɡ æ ɹ ʌ b ɔ l d i
G A R R O N S	ɡ ɛ ɹ ʌ n z
G A U G E S	ɡ eɪ dʒ ʌ z
G A U N T L E T	ɡ ɔ n t l ʌ t
G A U S S	ɡ aʊ s
G A Y T A N	ɡ eɪ t ʌ n
G E I K E N	ɡ aɪ k ʌ n
G E M C O	dʒ ɛ m k oʊ
G E M C R A F T	dʒ ɛ m k ɹ æ f t
G E N N A D I	dʒ ɛ n ɑ d i
G E N T H N E R	dʒ ɛ n θ n ɝ
G H A N A S	ɡ æ n ʌ z
G I G A N T E	dʒ i ɡ ɑ n t i
G I O V A N N I E L L O	dʒ oʊ v ɑ n i ɛ l oʊ
G I V A N	ɡ ɪ v ʌ n
G L E A S O N S	ɡ l i s ʌ n z
G L E G H O R N	ɡ l ɛ ɡ h ɝ n
G L O C E S T E R	ɡ l aʊ s t ɝ
G L O R I F Y	ɡ l ɔ ɹ ʌ f aɪ
G L U C O S E	ɡ l u k oʊ s
G O E L L N E R	ɡ oʊ l n ɝ
G O E M A N	ɡ oʊ m ʌ n
G O L E M B E S K I	ɡ ʌ l ɪ m b ɛ s k i
G O T C H A	ɡ ɑ tʃ ʌ
G O V E R N O R S H I P S	ɡ ʌ v ɝ n ɝ ʃ ɪ p s
G R A B E R	ɡ ɹ eɪ b ɝ
G R A T E S	ɡ ɹ eɪ t s
G R A T Z E R	ɡ ɹ eɪ t z ɝ
G R A V E S	ɡ ɹ eɪ v z
G R A V I T A T I O N A L L Y	ɡ ɹ æ v ʌ t eɪ ʃ n ʌ l i
G R E E N L A W	ɡ ɹ i n l ɔ
G R I M A C E D	ɡ ɹ ɪ m ʌ s t
G R I N D S T O N E	ɡ ɹ aɪ n d s t oʊ n
G R I S M E R	ɡ ɹ ɪ s m ɝ
G R O P P	ɡ ɹ ɑ p
G R U B E R O V A	ɡ ɹ u b ɛ ɹ oʊ v ʌ
G U B A	ɡ u b ʌ
G U Z Z L I N G	ɡ ʌ z l ɪ ŋ
G W Y N E T H S	ɡ w ɪ n ʌ θ s
H A C K S T A F F	h æ k s t æ f
H A F N I U M	h æ f n i ʌ m
H A G E W O O D	h eɪ dʒ w ʊ d
H A L L W A Y	h ɔ l w eɪ
H A M M E R M E I S T E R	h æ m ɝ m aɪ s t ɝ
H A N D L E R S	h æ n d ʌ l ɝ z
H A N D O U T S	h æ n d aʊ t s
H A N N I S	h æ n ɪ s
H A N S H I N	h æ n ʃ ɪ n
H A R D W A R E	h ɑ ɹ d w ɛ ɹ
H A R D W O R K I N G	h ɑ ɹ d w ɝ k ɪ ŋ
H A R E W O O D	h ɛ ɹ w ʊ d
H A R T Z	h ɑ ɹ t s
H A R V E S T A B L E	h ɑ ɹ v ʌ s t ʌ b ʌ l
H A S H I S H	h æ ʃ i ʃ
H A S S A N	h ʌ s ɑ n
H A S T E N S	h eɪ s ʌ n z
H A V I L L A N D	h æ v ʌ l ʌ n d
H A Y S T A C K S	h eɪ s t æ k s
H A Z L E	h eɪ z ʌ l
H E A L T H I N E S S	h ɛ l θ i n ʌ s
H E D I G E R	h ɛ d ɪ ɡ ɝ
H E E D I N G	h i d ɪ ŋ
H E E G	h i ɡ
H E M L E R	h ɛ m l ɝ
H E R M E S	h ɝ m i z
H I D Y	h aɪ d i
H I L D E G A R D	h ɪ l d ʌ ɡ ɑ ɹ d
H I N G I S	h ɪ ŋ ɡ ʌ s
H L A D	h l æ d
H O L S T	h oʊ l s t
H O M E S T R E T C H	h oʊ m s t ɹ ɛ tʃ
H O N O R I A	ɑ n ɝ i ʌ
H O R D E	h ɔ ɹ d
H O R N L E S S	h ɔ ɹ n l ʌ s
H O R S E H E A D	h ɔ ɹ s h ɛ d
H O S I N G	h oʊ z ɪ ŋ
H O U G H T A L I N G	h ɔ t ʌ l ɪ ŋ
H O W E R Y	h aʊ ɝ i
H R U B Y	h ɹ u b i
H U C K E R	h ʌ k ɝ
H U F F E D	h ʌ f t
H U I B R E G T S E	h u b ɹ ɛ k t s
H U R D L I N G	h ɝ d l ɪ ŋ
H Y D R A T E	h aɪ d ɹ eɪ t
H Y N E S	h aɪ n z
H Y P E R I N F L A T I O N	h aɪ p ɝ ɪ n f l eɪ ʃ ʌ n
I C K E S	aɪ k s
I C O N O C L A S M	aɪ k ɑ n ʌ k l æ z ʌ m
I D E	aɪ d
I D E A L I S M	aɪ d i l ɪ z ʌ m
I L Y A R O N O F F	ɪ l j ɑ ɹ ɔ n ɔ f
I M M U N O M E D I C	ɪ m j u n oʊ m ɛ d ɪ k
I M P E L L E D	ɪ m p ɛ l d
I M P L O D E S	ɪ m p l oʊ d z
I M P O S I T I O N	ɪ m p ʌ z ɪ ʃ ʌ n
I M P R O V I S E S	ɪ m p ɹ ʌ v aɪ z ʌ z
I N C O R R I G I B L E	ɪ n k ɑ ɹ ʌ dʒ ʌ b ʌ l
I N C U M B E N T S	ɪ n k ʌ m b ʌ n t s
I N D U L G E D	ɪ n d ʌ l dʒ d
I N F I N I T U M	ɪ n f ɪ n ɪ t ʌ m
I N H E R I T A N C E	ɪ n h ɛ ɹ ʌ t ʌ n s
I N Q U I S I T O R	ɪ n k w ɪ z ʌ t ɝ
I N T E R F E R E N C E	ɪ n ɝ f ɪ ɹ ʌ n s
I N T E R M E D I A T E S	ɪ n ɝ m i d i ʌ t s
I N T E R R O G A T O R	ɪ n t ɛ ɹ ʌ ɡ eɪ t ɝ
I N T E R V I E W S	ɪ n t ɝ v j u z
I N T I S	ɪ n t ɪ s
I N V E S T I G A T O R S	ɪ n v ɛ s t ʌ ɡ eɪ t ɝ z
I R I T	aɪ ɑ ɹ aɪ t i
I W A T A	i w ɑ t ɑ
J A N S S O N	dʒ æ n s ʌ n
J E A N E S	dʒ i n z
J E K E L	dʒ ɛ k ʌ l
J E N N E Y	dʒ ɛ n i
J E S P E R S O N	dʒ ɛ s p ɝ s ʌ n
J E W R Y	dʒ u ɹ i
J O B S	dʒ ɑ b z
J O H	dʒ oʊ
J O I N S	dʒ ɔɪ n z
J O Y N E S	dʒ ɔɪ n z
J U L I A N N E	dʒ u l i ɛ n
J U N K I E	dʒ ʌ ŋ k i
K A N D A	k æ n d ʌ
K A S L E R	k æ s ʌ l ɝ
K A T S	k æ t s
K A U C H E R	k aʊ k ɝ
K E A R S E	k ɝ s
K E M N E R	k ɛ m n ɝ
K E N N Y S	k ɛ n i z
K E V A N	k ɛ v ʌ n
K I	k i
K I M L E R	k ɪ m ʌ l ɝ
K I N G D O N	k ɪ ŋ d ʌ n
K I P E R	k aɪ p ɝ
K I T O W S K I	k ɪ t ɔ f s k i
K L A P P E R I C H	k l æ p ɝ ɪ k
K L E I N S A S S E R	k l aɪ n s ʌ s ɝ
K L E R K	k l ɝ k
K L E V E	k l i v
K L O C K E	k l ɑ k
K N I E F	n i f
K N I P P L E	n ɪ p ʌ l
K N I T T E D	n ɪ t ɪ d
K N O B	n ɑ b
K O B L E	k oʊ b ʌ l
K O C I E M B A	k oʊ s i ɛ m b ʌ
K O E R N E R	k ɔ ɹ n ɝ
K O H L E R	k oʊ l ɝ
K O O S	k u z
K O R E A G A T E	k ɔ ɹ i ʌ ɡ eɪ t
K O S L O W	k ɑ s l oʊ
K O S T E C K I	k ʌ s t ɛ t s k i
K O T E C K I	k ʌ t ɛ t s k i
K R A P E L S	k ɹ æ p ʌ l z
K R I N G	k ɹ ɪ ŋ
K R U G	k ɹ ʌ ɡ
K R U G E R R A N D	k ɹ u ɡ ɛ ɹ æ n d
K R U S Z Y N S K I	k ɹ ʌ ʃ ɪ n s k i
K U N E Y	k j u n i
K U P R E S	k u p ɹ ʌ s
L A B I N E	l ɑ b i n i
L A C O S S	l ʌ k ɑ s
L A D I N G	l eɪ d ɪ ŋ
L A D W I G	l æ d w ɪ ɡ
L A H I F F	l æ h ɪ f
L A M B A S T E S	l æ m b æ s t s
L A N D O V E R	l æ n d oʊ v ɝ
L A N E T E	l ʌ n i t
L A P S L E Y	l æ p s l i
L A S H O M B	l æ ʃ ʌ m
L A T H O U R I S	l ʌ θ u ɹ ɪ s
L A Z I E R	l eɪ z i ɝ
L E A N	l i n
L E I C H N E R	l aɪ k n ɝ
L E I N O	l eɪ i n oʊ
L E I S U R E	l i ʒ ɝ
L E P I S T O	l ɛ p i s t oʊ
L I E U	l j u
L I G N I N	l ɪ ɡ n ɪ n
L I K I N S	l ɪ k ɪ n z
L I M P E R T	l ɪ m p ɝ t
L I N D S E Y	l ɪ n d z i
L I O N S	l aɪ ʌ n z
L I P T O N	l ɪ p t ʌ n
L I S T E N	l ɪ s ʌ n
L O C U R T O	l oʊ k ʊ ɹ t oʊ
L O N G S T R E T H	l ɑ ŋ s t ɹ ɛ θ
L O P A T A	l oʊ p ɑ t ʌ
L O U G H R I D G E	l aʊ ɹ ɪ dʒ
L O U I S A	l u i z ʌ
L O V E G R O V E	l ʌ v ɡ ɹ oʊ v
L O V E T T	l ʌ v ɪ t
L O W	l oʊ
L U C I A	l u ʃ ʌ
L U G S	l ʌ ɡ z
L U L L I N G	l ʌ l ɪ ŋ
L U N C H E O N	l ʌ n tʃ ʌ n
L U N D Y	l ʌ n d i
L U N G E S	l ʌ n dʒ ɪ z
L Y T L E	l aɪ t ʌ l
L Y V E R S	l aɪ v ɝ z
M A B	m æ b
M A C R A E	m ʌ k ɹ eɪ
M A H M O U D	m æ m u d
M A H O N	m eɪ ʌ n
M A I O R A N O	m aɪ ɔ ɹ ɑ n oʊ
M A J K A	m aɪ k ʌ
M A L F U N C T I O N I N G	m æ l f ʌ ŋ k ʃ ʌ n ɪ ŋ
M A N A G E R	m æ n ʌ dʒ ɝ
M A N C I L L A	m æ n s ɪ l ʌ
M A N D A L A	m ɑ d ʌ l ʌ
M A N I A	m eɪ n i ʌ
M A N I A C A L	m ʌ n aɪ ʌ k ʌ l
M A R I B E L	m ɑ ɹ ɪ b ɛ l
M A R M A L A D E	m ɑ ɹ m ʌ l eɪ d
M A R T I R O S O V	m ɑ ɹ t ɪ ɹ ʌ s ɑ v
M A R V I N S	m ɑ ɹ v ɪ n z
M A S S O	m æ s oʊ
M A S T R O N A R D I	m æ s t ɹ oʊ n ɑ ɹ d i
M A T T O S	m æ t oʊ z
M A U S O L F	m aʊ s oʊ l f
M A Y A N S	m aɪ ʌ n z
M A Z D A	m ɑ z d ʌ
M A Z Y C K	m æ z ɪ k
M C C O N E	m ʌ k oʊ n
M C C O N N E L L S	m ʌ k ɑ n ʌ l z
M C C O Y	m ʌ k ɔɪ
M C C R O R Y	m ʌ k ɹ ɔ ɹ i
M C C U I S T I O N	m ʌ k w ɪ ʃ ʌ n
M C C U L L E R S	m ʌ k ʌ l ɝ z
M C G R E G O R	m ʌ ɡ ɹ ɛ ɡ ɝ
M C G R E G O R Y	m ʌ ɡ ɹ ɛ ɡ ɝ i
M C I L R A T H	m æ k ʌ l ɹ æ θ
M C K E A N D	m ʌ k i n d
M C K E N Z I E	m ʌ k ɛ n z i
M C N I S H	m ʌ k n ɪ ʃ
M E D I A	m i d i ʌ
M E D I C S	m ɛ d ɪ k s
M E D I G A P	m ɛ d ɪ ɡ æ p
M E L D	m ɛ l d
M E L I C A N	m ɛ l ɪ k ʌ n
M E L L E Y	m ɛ l i
M E R I T L E S S	m ɛ ɹ ɪ t l ʌ s
M E R L	m ɝ l
M E S A R O S	m eɪ s ɑ ɹ oʊ z
M E T R O S E X U A L	m ɛ t ɹ ʌ s ɛ k ʃ u ʌ l
M E T T L E N	m ɛ t l ʌ n
M E T Z G E R S	m ɛ t s ɡ ɝ z
M I C R O B I L T	m aɪ k ɹ oʊ b ɪ l t
M I L B A N K	m ɪ l b æ ŋ k
M I L E S T O N E	m aɪ l s t oʊ n
M I L E W S K I	m ɪ l ɛ f s k i
M I L L I K I N	m ɪ l ɪ k ɪ n
M I L S T E A D	m ɪ l s t ɛ d
M I L T	m ɪ l t
M I N E R A L O G I S T	m ɪ n ɝ ɑ l ʌ dʒ ɪ s t
M I S S O U R I S	m ʌ z ɝ ʌ z
M I Y A H A R A	m i j ɑ h ɑ ɹ ʌ
M L O T O K	m ʌ l ɑ t ɑ k
M N E M O N I C	n i m ɑ n ɪ k
M O H A M A D	m ʌ h ɑ m ʌ d
M O K O E N A	m ʌ k oʊ n ʌ
M O M E N T S	m oʊ m ʌ n t s
M O N E Y W E E K	m ʌ n i w i k
M O N T H L O N G	m ʌ n θ l ɔ ŋ
M O R I S O N	m ɔ ɹ ɪ s ʌ n
M O R M A N	m ɔ ɹ m ʌ n
M O T I V A T E	m oʊ t ʌ v eɪ t
M R O C Z E K	m ɹ ɑ tʃ ɛ k
M U D D I E R	m ʌ d i ɝ
M U L L D O R F E R	m ʌ l d ɔ ɹ f ɝ
M U L L I K I N	m ʌ l ɪ k ɪ n
M U L T I D E X	m ʌ l t ɪ d ɛ k s
M U S I C S	m j u z ɪ k s
M Y S T I F I E D	m ɪ s t ʌ f aɪ d
N A K E D	n eɪ k ʌ d
N A P P I N G	n æ p ɪ ŋ
N A T I O N A I R	n eɪ ʃ ʌ n ɛ ɹ
N A T U R A L I Z E D	n æ tʃ ɝ ʌ l aɪ z d
N A T U R A L I Z E S	n æ tʃ ɝ ʌ l aɪ z ɪ z
N A U S E A T E D	n ɔ z i eɪ t ʌ d
N A V A	n ɑ v ʌ
N A V A R R O	n ʌ v ɑ ɹ oʊ
N E O P R O B E	n i oʊ p ɹ oʊ b
N E R I O	n ɛ ɹ i oʊ
N E S S L E R	n ɛ s l ɝ
N E U T R A L I Z E S	n u t ɹ ʌ l aɪ z ɪ z
N E W B E R R Y	n u b ɛ ɹ i
N E W B O L D	n u b oʊ l d
N E W T O W N E	n u t aʊ n
N I E M E Y E R	n i m aɪ ɝ
N I K K E I S	n i k eɪ z
N I N E S	n aɪ n z
N I X I E	n ɪ k s i
N O N A	n oʊ n ɑ
N O N B I N D I N G	n ɑ n b aɪ n d ɪ ŋ
N O N E N T I T Y	n ɑ n ɛ n t ʌ t i
N O N S T O P S	n ɑ n s t ɑ p s
N O N V O L A T I L E	n ɑ n v ɑ l ʌ t ʌ l
N U D E L M A N	n ʌ d ʌ l m ʌ n
N U T R I C L E A N	n u t ɹ ɪ k l i n
N Y E R S	n aɪ ɹ z
N Y G A A R D	n aɪ ɡ ɑ ɹ d
O	oʊ
O B L I Q U E L Y	ʌ b l i k l i
O B R I A N	oʊ b ɹ aɪ ʌ n
O B T A I N E D	ʌ b t eɪ n d
O F F E N D E D	ʌ f ɛ n d ʌ d
O F I V E	oʊ f aɪ v
O H L S O N	oʊ l s ʌ n
O K O N I E W S K I	oʊ k ɑ n j ɛ f s k i
O O H S	u z
O P E R A T I O N A L L Y	ɑ p ɝ eɪ ʃ n ʌ l i
O P H T H A L M O L O G I S T	ɑ f θ ʌ m ɑ l ʌ dʒ ɪ s t
O P I N E S	oʊ p aɪ n z
O P T I M I S T I C	ɑ p t ɪ m ɪ s t ɪ k
O R K S	ɔ ɹ k s
O R T E G A S	ɔ ɹ t eɪ ɡ ʌ z
O T T I N G	ɑ t ɪ ŋ
O U T F L O W S	aʊ t f l oʊ z
O V A R Y	oʊ v ɝ i
O V E R H O L T	oʊ v ɝ h oʊ l t
O V E R H O L T Z E R	oʊ v ɝ h oʊ l t z ɝ
O V E R P O P U L A T E S	oʊ v ɝ p ɑ p j ʌ l eɪ t s
O V E R S H A D O W E D	oʊ v ɝ ʃ æ d oʊ d
O V E R W H E L M I N G	oʊ v ɝ h w ɛ l m ɪ ŋ
O W N S	oʊ n z
P A I N S	p eɪ n z
P A L L E T	p æ l ʌ t
P A N E L I S T	p æ n ʌ l ʌ s t
P A P A R A Z Z I S	p ɑ p ɑ ɹ ɔ z i z
P A R A L Y T I C	p ɛ ɹ ʌ l ɪ t ɪ k
P A R D O N E D	p ɑ ɹ d ʌ n d
P A R L I A M E N T A R I A N	p ɑ ɹ l ʌ m ɛ n t ɛ ɹ i ʌ n
P A R L I A M E N T S	p ɑ ɹ l ʌ m ɛ n t s
P A R L O W	p ɑ ɹ l oʊ
P A R S	p ɑ ɹ z
P A T R O N A G E	p eɪ t ɹ ʌ n ʌ dʒ
P A T T E R E D	p æ t ɝ d
P A W L O W I C Z	p ɑ v l ʌ v ɪ tʃ
P A Y B A C K	p eɪ b æ k
P E A L E	p i l
P E L L E U	p ɛ l u
P E N T A M I D I N E	p ɛ n t æ m ɪ d i n
P E R E G R I N E S	p ɛ ɹ ʌ ɡ ɹ i n z
P E R I M E T E R	p ɝ ɪ m ʌ t ɝ
P E R I T O N E A L	p ɛ ɹ i t oʊ n i ʌ l
P E R R E T T I	p ɝ ɹ ɛ t i
P E R S O N N E L	p ɝ s ʌ n ɛ l
P E T O	p i t oʊ
P H I L O D E N D R O N	f ɪ l ʌ d ɛ n d ɹ ʌ n
P H O T O R E F R A C T I V E	f oʊ t oʊ ɹ ɪ f ɹ æ k t ɪ v
P I C K F O R D	p ɪ k f ɝ d
P I C O U	p i k u
P I G O T T	p ɪ ɡ ʌ t
P I T F A L L S	p ɪ t f ɔ l z
P L A C A T E	p l eɪ k eɪ t
P L A I T S	p l eɪ t s
P L A N N E R	p l æ n ɝ
P L A Y B O O K	p l eɪ b ʊ k
P L A Y O F F S	p l eɪ ɔ f s
P L E S S I N G E R	p l ɛ s ɪ ŋ ɝ
P L O E G E R	p l oʊ ɡ ɝ
P L U S S	p l ʌ s ɪ z
P O L E S	p oʊ l z
P O L S T O N	p oʊ l s t ʌ n
P O M O L O G Y	p oʊ m ɑ l ʌ dʒ i
P O P P E L L	p ɑ p ʌ l
P O R A D A	p ɔ ɹ ɑ d ʌ
P O R N O G R A P H I C	p ɔ ɹ n ʌ ɡ ɹ æ f ɪ k
P O T T O R F F	p ɑ t ɝ f
P O U D R I E R	p aʊ d ɹ i ɝ
P O U S S O N	p u s ɑ n
P O U T R E	p aʊ t ɝ
P O W E R S	p aʊ ɝ z
P R A Y E R	p ɹ eɪ ɝ
P R A Y E R F U L	p ɹ eɪ ɝ f ʌ l
P R E S C O T	p ɹ ɛ s k ʌ t
P R E S E N T I N G	p ɹ ɪ z ɛ n t ɪ ŋ
P R E S S	p ɹ ɛ s
P R E S S L E R	p ɹ ɛ s l ɝ
P R I S B U R G	p ɹ ɪ s b ɝ ɡ
P R I V O T T	p ɹ ɪ v ʌ t
P R O C L I V I T Y	p ɹ oʊ k l ɪ v ʌ t i
P R O C R E A T E S	p ɹ oʊ k ɹ i eɪ t s
P R O S E R V	p ɹ oʊ s ɝ v
P R O T E I N	p ɹ oʊ t i n
P S Y C H E D	s aɪ k t
P U B L I S H E R S	p ʌ b l ɪ ʃ ɝ z
P U L K R A B E K	p ʌ l k ɹ ʌ b ɪ k
P U T I N	p u t ɪ n
Q U I N N S	k w ɪ n z
Q U I T	k w ɪ t
R A H R I G	ɹ æ ɹ ɪ ɡ
R A I L C A R S	ɹ eɪ l k ɑ ɹ z
R A I N E	ɹ eɪ n
R A M E R I Z	ɹ ɑ m ɛ ɹ i z
R A N C H	ɹ æ n tʃ
R A N D I	ɹ æ n d i
R A N D O M	ɹ æ n d ʌ m
R A Y M A R K S	ɹ eɪ m ɑ ɹ k s
R E A L I Z I N G	ɹ i ʌ l aɪ z ɪ ŋ
R E B U F F E D	ɹ i b ʌ f t
R E C O R D E R	ɹ i k ɔ ɹ d ɝ
R E C U R R I N G	ɹ i k ɝ ɪ ŋ
R E D L I N	ɹ ɛ d l ɪ n
R E F E R E N D U M S	ɹ ɛ f ɝ ɛ n d ʌ m z
R E F O C U S E D	ɹ i f oʊ k ʌ s t
R E F U T A T I O N	ɹ ɛ f j u t eɪ ʃ ʌ n
R E G R E T T A B L Y	ɹ ɪ ɡ ɹ ɛ t ʌ b l i
R E H A B I L I T A T I V E	ɹ i ʌ b ɪ l ʌ t eɪ t ɪ v
R E H A B I L I T A T O R S	ɹ i h ʌ b ɪ l ʌ t eɪ t ɝ z
R E I M P O S E D	ɹ i ɪ m p oʊ z d
R E I N T E R P R E T E D	ɹ i ɪ n t ɝ p ɹ ʌ t ɪ d
R E M E M B E R S	ɹ ɪ m ɛ m b ɝ z
R E M O L D E D	ɹ i m oʊ l d ɪ d
R E S E M B L I N G	ɹ i z ɛ m b l ɪ ŋ
R E S O R T S	ɹ ɪ z ɔ ɹ t s
R E W A R D	ɹ i w ɔ ɹ d
R E W I R E	ɹ i w aɪ ɝ
R E Y N A	ɹ eɪ n ʌ
R H O A D E S	ɹ oʊ d z
R I A L S	ɹ aɪ l z
R I C K E Y	ɹ ɪ k i
R I D I N G E R	ɹ aɪ d ɪ ŋ ɝ
R I N G E D	ɹ ɪ ŋ d
R I V A L	ɹ aɪ v ʌ l
R I V A L I N G	ɹ aɪ v l ɪ ŋ
R I V I E R E S	ɹ ɪ v j ɪ ɹ ɛ z
R O B S O N	ɹ ɑ b s ʌ n
R O G G O W	ɹ ɑ ɡ oʊ
R O M A N T I C A L L Y	ɹ oʊ m æ n t ɪ k l i
R O O T L E S S	ɹ u t l ʌ s
R O S E V E A R	ɹ oʊ z v ɪ ɹ
R O S S B O R O U G H	ɹ ɔ s b ɝ oʊ
R O S W A L D	ɹ ɑ s w ʌ l d
R O U T I N E	ɹ u t i n
R O Y E X S	ɹ ɔɪ ɛ k s ɪ z
R U A	ɹ u ʌ
R U B A L C A B A	ɹ u b ɑ l k ɑ b ʌ
R U C H	ɹ ʌ tʃ
R U D N I K	ɹ ʌ d n ɪ k
R U G G I R E L L O	ɹ u dʒ ɪ ɹ ɛ l oʊ
R U I N I N G	ɹ u ɪ n ɪ ŋ
R U L L I	ɹ u l i
R U M S	ɹ ʌ m z
R U N N E R S	ɹ ʌ n ɝ z
R U S S I F I E D	ɹ ʌ s ʌ f aɪ d
S A A T C H I	s ɑ tʃ i
S A I N T S A E N S	s eɪ n t s ɑ n z
S A L E H	s ɑ l ɛ h
S A L G A D O	s ɑ l ɡ ɑ d oʊ
S A L O O J E E	s ʌ l u dʒ i
S A M E T	s æ m ɪ t
S A N G U I N E	s æ ŋ ɡ w ɪ n
S A N T I L L A N E S	s æ n t ɪ l eɪ n z
S A P O N E	s ɑ p oʊ n i
S A R I N E	s ɑ ɹ i n i
S A T H R E	s æ θ ɝ
S A T T E R L Y	s æ t ɝ l i
S A U L T	s ɔ l t
S A U N D R A	s ɔ n d ɹ ʌ
S A V O R Y	s eɪ v ɝ i
S A W K A	s ɔ k ʌ
S C H E D U L E	s k ɛ dʒ ʊ l
S C H E I D E R E R	ʃ aɪ d ɝ ɝ
S C H L U T E R	ʃ l u t ɝ
S C H O C K	ʃ ɑ k
S C H O O L T E A C H E R	s k u l t i tʃ ɝ
S C H R E C K	ʃ ɹ ɛ k
S C H R U P P	ʃ ɹ ʌ p
S C H W I S O W	ʃ w ɪ s oʊ
S C O R E K E E P E R	s k ɔ ɹ k i p ɝ
S C O T L A N D	s k ɑ t l ʌ n d
S C O W L I N G	s k aʊ l ɪ ŋ
S C R A N T O N	s k ɹ æ n t ʌ n
S C R A P E	s k ɹ eɪ p
S C R A P P E D	s k ɹ æ p t
S C R E E N I N G	s k ɹ i n ɪ ŋ
S C U F F E D	s k ʌ f t
S E A S O N A L L Y	s i z n ʌ l i
S E E S A W I N G	s i s ɔ ɪ ŋ
S E G U R A	s eɪ ɡ ʊ ɹ ʌ
S E I N F E L D	s aɪ n f ɛ l d
S E L F L E S S N E S S	s ɛ l f l ʌ s n ɪ s
S E L F P E R P E T U A T E	s ɛ l f p ɝ p ɛ tʃ u eɪ t
S E L F P E R P E T U A T I O N	s ɛ l f p ɝ p ɛ tʃ u eɪ ʃ ʌ n
S E R V I C E D	s ɝ v ɪ s t
S E S S I O N	s ɛ ʃ ʌ n
S H A R L A	ʃ ɑ ɹ l ʌ
S H A W H A N	ʃ æ w ʌ n
S H E A R E D	ʃ ɪ ɹ d
S H E N A N D O A H	ʃ ɛ n ʌ n d oʊ ʌ
S H I M K U S	ʃ ɪ m k ʌ s
S H I M M I N	ʃ ɪ m ɪ n
S H I R E L L E	ʃ ɪ ɹ ɛ l
S H R I N E	ʃ ɹ aɪ n
S I C H E L	s ɪ k ʌ l
S I N G E L	s ɪ ŋ ɡ ʌ l
S I T I N G	s aɪ t ɪ ŋ
S K I N N I E R	s k ɪ n i ɝ
S L O A N S	s l oʊ n z
S L U G G E R S	s l ʌ ɡ ɝ z
S M E L L E Y	s m ɛ l i
S N O W D E N	s n oʊ d ʌ n
S O	s oʊ
S O L	s oʊ l
S O Y S A U C E	s ɔɪ s ɔ s
S P E A K E R S	s p i k ɝ z
S P E C I A L I T Y	s p ɛ ʃ i æ l ɪ t i
S P E C U L A T I N G	s p ɛ k j ʌ l eɪ t ɪ ŋ
S P E T S N A Z	s p ɛ t s n æ z
S P O R T	s p ɔ ɹ t
S P R I N G F I E L D S	s p ɹ ɪ ŋ f i l d z
S R I	ɛ s ɑ ɹ aɪ
S R I	s ɹ i
S T A K E S	s t eɪ k s
S T A L L I B R A S S	s t æ l ɪ b ɹ æ s
S T A N F I E L D	s t æ n f i l d
S T A R S T R E A M	s t ɑ ɹ s t ɹ i m
S T A T E H O U S E S	s t eɪ t h aʊ s ɪ z
S T E E P L Y	s t i p l i
S T E I N F E L D	s t aɪ n f ɛ l d
S T E L Z N E R	s t ɛ l z n ɝ
S T I C K I E S T	s t ɪ k i ʌ s t
S T I C K L E S	s t ɪ k ʌ l z
S T I L L I N G S	s t ɪ l ɪ ŋ z
S T I L T S	s t ɪ l t s
S T I N E L S	s t ɪ n ɛ l z
S T L O U I S	s eɪ n t l u ʌ s
S T R E G E	s t ɹ i dʒ
S T R E I S A N D	s t ɹ aɪ s æ n d
S U B S I S T E N C E	s ʌ b s ɪ s t ʌ n s
S U C C E S S I O N	s ʌ k s ɛ ʃ ʌ n
S U M O	s u m oʊ
S U P E R C O O L E D	s u p ɝ k u l d
S U P P L E M E N T A R Y	s ʌ p l ʌ m ɛ n t ʌ ɹ i
S U R P L U S	s ɝ p l ʌ s
S W A I N	s w eɪ n
S Z Y D L O W S K I	ʃ ɪ d l ɔ f s k i
S Z Y M A N S K I	ʃ ɪ m æ n s k i
T A F O Y A	t ɑ f ɔɪ ʌ
T A G G A R T	t æ ɡ ɝ t
T A I L E D	t eɪ l d
T A M I A M I	t æ m i æ m i
T A R	t ɑ ɹ
T A R R A N C E	t ɑ ɹ ʌ n s
T A U G H T	t ɔ t
T A U S C H E R	t aʊ ʃ ɝ
T E E T H I N G	t i ð ɪ ŋ
T E L E P H O N I N G	t ɛ l ʌ f oʊ n ɪ ŋ
T E R R I B L E	t ɛ ɹ ʌ b ʌ l
T E R T I A	t ɛ ɹ ʃ ʌ
T E R Z I A N	t ɝ z i ʌ n
T H A N K L E S S	θ æ ŋ k l ʌ s
T H A T C H E R I S M	θ æ tʃ ɝ ɪ z ʌ m
T H E R M A E	θ ɝ m i
T H E Y L L	ð ɛ l
T H I N	θ ɪ n
T H R E A D F I N	θ ɹ ɛ d f ɪ n
T H U N D E R I N G	θ ʌ n d ɝ ɪ ŋ
T H U R N E R	θ ɝ n ɝ
T I B E T	t ʌ b ɛ t
T I D M O R E	t ɪ d m ɔ ɹ
T I P P E T T S	t ɪ p ɪ t s
T I R E L E S S	t aɪ ɝ l ʌ s
T I S	t ɪ z
T O M E Y	t oʊ m i
T O R A N	t ɔ ɹ ɑ n
T O R I E	t ɔ ɹ i
T O U C H E S	t ʌ tʃ ɪ z
T O W N H O U S E S	t aʊ n h aʊ s ɪ z
T R A I N E R S	t ɹ eɪ n ɝ z
T R A N S K E I	t ɹ æ n z k eɪ
T R E M A I N E	t ɹ ɪ m eɪ n
T R I B L E	t ɹ ɪ b ʌ l
T R I P T Y C H	t ɹ ɪ p t ɪ k
T R O I A N O	t ɹ oʊ i ɑ n oʊ
T R O U B H	t ɹ u b
T S C H U D Y	tʃ u d i
T U M U L T Y	t u m ʌ l t i
T Y C O O N	t aɪ k u n
T Y R E	t aɪ ɝ
T Y R R H E N I A N	t ɝ i n i ʌ n
T Y S I N G E R	t aɪ s ɪ n dʒ ɝ
U E L M A N	ʊ l m ʌ n
U H L E	u ʌ l
U L L A N D	ʌ l ʌ n d
U L T R A S Y S T E M	ʌ l t ɹ ʌ s ɪ s t ʌ m
U M B R I A	ʌ m b ɹ i ʌ
U N B R O K E N	ʌ n b ɹ oʊ k ʌ n
U N E A S I L Y	ʌ n i z ʌ l i
U N H O R S E D	ʌ n h ɔ ɹ s t
U N P A C K	ʌ n p æ k
U N S P A R I N G	ʌ n s p ɛ ɹ ɪ ŋ
U N S U S P E C T I N G	ʌ n s ʌ s p ɛ k t ɪ ŋ
U N T R A C E A B L E	ʌ n t ɹ eɪ s ʌ b ʌ l
U P T U R N	ʌ p t ɝ n
U R B A N A	ɝ b æ n ʌ
U S A G E S	j u s ʌ dʒ ʌ z
U S E F U L S	j u s f ʌ l z
U Y E H A R A	u j eɪ h ɑ ɹ ʌ
V A N L U E	v æ n l u
V A N S A N T	v ɑ n s ʌ n t
V A R I A N C E S	v ɛ ɹ i ʌ n s ɪ z
V A S H I N S K Y	v ʌ ʃ ɪ n s k i
V E L T R I	v ɛ l t ɹ i
V E N T I M I G L I A	v ɛ n t ɪ m ɪ ɡ l i ʌ
V I A T O R	v aɪ eɪ t ɝ
V I C E N Z I	v ɪ s ɛ n z i
V I C I S S I T U D E S	v ɪ s ɪ s ɪ t u d z
V I G I L I A	v i dʒ i l i ʌ
V I L L E G A S	v ɪ l ɪ ɡ ʌ z
V I T A L	v aɪ t ʌ l
V I V I D	v ɪ v ɪ d
V O L U N T E E R S	v ɑ l ʌ n t ɪ ɹ z
V O U G H T	v ɔ t
V O W E L	v aʊ ʌ l
W A D I N G	w eɪ d ɪ ŋ
W A R T H E N	w ɔ ɹ θ ʌ n
W A R W I C K	w ɔ ɹ w ɪ k
W A T F O R D	w ɔ t f ɝ d
W A Y L A I D	w eɪ l eɪ d
W E B B	w ɛ b
W E S T M A R C	w ɛ s t m ɑ ɹ k
W H E R E A B O U T S	h w ɛ ɹ ʌ b aʊ t s
W H I N N E R Y	h w ɪ n ɝ i
W H I T E F I S H	h w aɪ t f ɪ ʃ
W H O L E Y	h ɑ l i
W H O V E	h u v
W I E G A N D	w i ɡ ʌ n d
W I L L E S	w aɪ l z
W I L N E R	w ɪ l n ɝ
W I L T G E N	w ɪ l t ɡ ʌ n
W I N C K L E R	w ɪ ŋ k l ɝ
W I N S O M E	w ɪ n s ʌ m
W I S I N S K I	v ɪ s ɪ n s k i
W O L L I N	w ɑ l ɪ n
W O Z N I C K	w ɑ z n ɪ k
W R Y L Y	ɹ aɪ l i
Y A N E Y	j eɪ n i
Y A N N I	j æ n i
Y A Z O V	j ɑ z ɔ v
Y E S T E R D A Y	j ɛ s t ɝ d eɪ
Y O M	j ɑ m
Y O U R S E L V E S	j ɔ ɹ s ɛ l v z
Z E A L O T S	z ɛ l ʌ t s
Z E L I K O W	z ɛ l ɪ k oʊ
Z I E B E L L	z i b ɛ l
Z I E S K E	z i s k
Z I E T L O W	z i t l oʊ
Z I M M E R S	z ɪ m ɝ z
Z O G H B Y	z oʊ b i
Z O N E	z oʊ n
Z U E H L K E	z ʊ l k
Z W A R T	z w ɔ ɹ t
